#                           #
# .$.$.$.$.$.$.$.$.$.$.$.$. #
# $.$.$.$.$.$.$.$.$.$.$.$.$ #
# .$.$.$.$.$.$.$.$.$.$.$.$. #
# $.$.$.$.$.$.$.$.$.$.$.$.$ #
# .$.$.$.$.$.$.$.$.$.$.$.$. #
# $.$.$.$.$.$.$.$.$.$.$.$.$ #
# .$.$.$.$.$.$@$.$.$.$.$.$. #
# $.$.$.$.$.$.$.$.$.$.$.$.$ #
# .$.$.$.$.$.$.$.$.$.$.$.$. #
# $.$.$.$.$.$.$.$.$.$.$.$.$ #
# .$.$.$.$.$.$.$.$.$.$.$.$. #
# $.$.$.$.$.$.$.$.$.$.$.$.$ #
# .$.$.$.$.$.$.$.$.$.$.$.$. #
#                           #
