############## #######
#             #       #
#.##########  #$#####  #
#           #        #  #
#*########  # ######  #  #
#         #         #  #  #
#*######  # #######  #  #  #
#       #          #  #  #  #
#*####  # ########  #  #  #  #
#     #           #  #  #  # #
#*##  # #########  #  #  # # #
#   #            #  #  # # # #
#$  # ##########  #  # # # # #
# #             #  # # # # # #
# # ###########  # # # # # # #
#. @           $ * * * * * . #
