#   #   ##  #  #
# .$. $  # . . #
## ### #  $ #$ #
# . #  ### ##.##
#  $ .$  #. #  #
### ## #  $  $ #
##  #  ### ##  #
#  ## ###  #  ##
# $  $  # ## ###
#  # .#  $. $  #
##.## ###  # . #
# $# $  # ### ##
# . . #@ $ .$. #
#  #  ##   #   #
