#   ##
#  $ #####
##  $ #  #
 ## $ # $###########
  ##      $ $ $ $  #
   #####$ # # #  # #
       #      #    #
       # #######$#######
      ##         #@#   #
      #  # # ##  #     #
      #..*.*.*......   #
      ##########    # ##
               ####   #
                  #####
