#.      .   .   .   .      .#
# ##  # #   # # #   # #  ## #
# ##  $ # $ # $ # $ # $  ## #
#  ##$$$#$$$#$$$#$$$#$$$##  #
#   $...$...$...$...$...$   #
#  $$.#.$.#.$.#.$.#.$.#.$$  #
#   $...$...$...$...$...$   #
#.###$$$#$$$#$@$#$$$#$$$###.#
#   $...$...$...$...$...$   #
#  $$.#.$.#.$.#.$.#.$.#.$$  #
#   $...$...$...$...$...$   #
#  ##$$$#$$$#$$$#$$$#$$$##  #
# ##  $ # $ # $ # $ # $  ## #
# ##  # #   # # #   # #  ## #
#.      .   .   .   .      .#
