#          
       ####
  #### # .#
  #  ###@*#
  #.    # #
 ####$$ $ #
##      . #
#         #
#        ##
####   ### 
   #####   
