#          
       ####
  #### #*@#
  #  ### *#
  #     # #
  ###   $ #
####      #
#    .  $ #
#        ##
##.#   ### 
 #######   
