#          
       ### 
  #### #*##
 ##  ### +#
 #.     #$#
 ####   $ #
 ###      #
 #      * #
 #       ##
 ###   ### 
   #####   
