#          
       ####
  #### #. #
  #  ###$.#
  #@$   $ #
#####    .#
#  #      #
#         #
##       ##
 ###   ### 
   #####   
