#          
       ####
  #### #@.#
  #  ### *#
  #     # #
  ###     #
####      #
#  $$     #
#       .##
####   ### 
   #####   
