#          
       ####
  ###  #*@#
 ##*#### *#
 #.     # #
#####     #
#         #
#  #    $ #
#        ##
####   ### 
   #####   
