#          
       ####
  #### #*@#
  #  ### *#
  #.    # #
#####     #
#  #      #
#       $ #
#        ##
####   ### 
   #####   
