#          
  ###  ####
  #@## #  #
 ##  ###..#
 #. $     #
#####     #
#  #    # #
# $ $   . #
#   $    ##
####   ### 
   #####   
