#          
       ####
  #### # .#
 ##  ### .#
 #.     # #
#####  $$ #
#      $  #
#  #@   * #
#        ##
####   ### 
   #####   
