#          
       ####
  #### # @#
  #  ### .#
  #.    # #
#####     #
#  #      #
# $ $    .#
#   $    ##
####   ### 
   #####   
