#          
       ####
  #### #*@#
 ##  ### *#
 #.     # #
#####   $ #
#         #
#  #    * #
#        ##
####   ### 
   #####   
