#          
       ####
  #### #  #
 ##  ###@*#
 #.     # #
#####   $ #
#  #      #
#       * #
###      ##
  ##   ### 
   #####   
