#          
       ####
  #### # @#
  #  ###**#
  #     # #
  ###   $ #
####      #
#    .  $ #
#        ##
##.#   ### 
 #######   
