#          
       ####
  #### #  #
  #  ###@*#
  #.  $ # #
#####   $ #
#       . #
#  #      #
#        ##
####   ### 
   #####   
