#          
#          
  ####     
 ##  ####  
 #.     ###
 ####.    #
####      #
# $     . #
# @$$    ##
####   ### 
   #####   
