#          
       ####
  #### #@ #
  #  ###**#
  #     # #
  ###     #
####      #
#       $ #
#        ##
##.#   ### 
 #######   
