#          
       ####
  #### #@ #
  #  ###**#
  #.    # #
#####     #
#  #      #
#       $ #
#        ##
####   ### 
   #####   
