#          
       ####
  #### #  #
  #  ### .#
  #     # #
 ####     #
 #  @     #
 # #      #
 # $     ##
 ###   ### 
   #####   
