               
  #########    
  #  ##   #    
  #  #  . #    
  #  # #  #    
  ##$#@#$##    
  #  # #  #    
  # .  #  #    
  #   ##  #    
  #########    
               
               
               
               
               
