  #####
 ##   ###
 # .# $@#
 #  # # #
 # *  $.#
 #    ###
 ######
