 #######
 #@*  ##
 # $#  #
 # $ . #
 #.   ##
 #######
