 #######
 ###  @#
 #. *# #
 #   $ #
 # $. ##
 #######
