 #####
 #@  ###
 # $$$ #
 ## ...#
 #   # #
 #     #
 #######
