 #######
 #  ####
 #   ###
 #$ $@##
 #. #$ #
 #  . .#
 #######
