 ######
 #@  .#
 #$$$ #
 #. # #
 #  . #
 ######
