 #######
 #@    ##
 # # #$ #
 #. $*  #
 #   # .#
 ########
