 ######
 #   @##
 #  #* #
 #   $ #
 #  $..#
 #######
