    #####
 #### . #
 # @$   #
 #   ** #
 #    ###
 ######
