 #######
 #.  ###
 # # $ #
 #  *  #
 #  ## #
 # *  @#
 #######
