 #######
 #     ##
 # #@#  #
 #.$$$. #
 #   #. #
 ########
