 ########
 #@.#####
 #$$   ##
 #.$ # ##
 #  .  ##
 ########
