 #####
 #   #
 # # ###
 #. $$ #
 #.  # #
 #  *@ #
 #######
