 ########
 ##.   ##
 #  $$$+#
 # # #  #
 #.    ##
 ########
