 #######
 ##.  ##
 #+$$$ #
 # #  .#
 #    ##
 #######
