 #####
 #   ##
 #.   ##
 # #.$ #
 # $$# #
 ##@.  #
  ######
