 #######
 ##   ##
 ## #.##
 #  $.##
 # # $ #
 #  * @#
 #######
