 #####
 #   ##
 # #$ ##
 #. *  #
 # $#  #
 #+ *  #
 #######
