 ########
 ##@ ####
 ##$$   #
 #  $ # #
 # # ...#
 #   ####
 ########
