 ######
 #@ * ###
 # #    #
 #.$$.# #
 #      #
 ########
