 #######
 #@ .. ##
 # $ #  #
 # #$$  #
 #   #  #
 #.  #  #
 ########
