 ########
 ## .$@##
 ## *$$ #
 # .    #
 # # #  #
 #  .####
 ########
