 #####
 #. .####
 #$$    #
 #@$#   #
 # .    #
 ########
