 ######
 #    #
 # ## ##
 # . * ###
 ## $ *  #
  #  #  @#
  ########
