 ######
 #    ###
 # @#$  #
 # *.$  #
 # . #  #
 ########
