 ######
 #    #
 # ## ##
 # .$@.###
 ## $$   #
  #  #.  #
  ########
