 ########
 # .$ ###
 #   $+##
 #$  # ##
 #. .$ ##
 ########
