 #######
 #### @#
 ##.$$.#
 #  $ ##
 # # .##
 # $ .##
 #######
