 #######
 ###+ ##
 #  $$ #
 # #$  #
 #.   .#
 #######
