 ######
 #@ .####
 # * $  #
 # $# # #
 #   .  #
 ########
