 #######
 ##  ###
 ## .$ #
 # $$  #
 # #. .#
 #@  ###
 #######
