 ######
 #    #
 # ##*##
 #   * ###
 ##   $  #
  # @#.  #
  ########
