 #######
 #@*  ##
 #$$$  #
 #.  # #
 #   ..#
 #######
