 ########
 ##@  ###
 #.$*$  #
 # #   .#
 #    ###
 ########
