   #####
  ##   #
 ## .  ###
 #@$$$$  #
 # #. ## #
 #  . .  #
 #########
