 ########
 ##  ####
 ## * . #
 # $  # #
 # # $  #
 #@ .####
 ########
