  #####
 ##@  ##
 # $*$ #
 #.  # #
 # #.  #
 #    ##
 ######
