 ########
 ##  ####
 #+   ###
 # #$   #
 #  $$  #
 ##. .###
 ########
