 ######
 #    #
 # ## ##
 #  *. ###
 ##$  $  #
  #. #  @#
  ########
