 #######
 ##  .##
 ## #$##
 # $  ##
 # # $.#
 # .  @#
 #######
