 #######
 # .$@##
 # .$$.#
 #$  # #
 #.    #
 #######
