 ########
 ##. ####
 ##.$  .#
 #.$  # #
 # #$$  #
 #@  ####
 ########
