 ########
 ###  ###
 ###   ##
 ###$   #
 ### .# #
 # *$. @#
 #    ###
 ########
