 #######
 ##.  ##
 #*.# ##
 #.$ $ #
 #$  # #
 #   *@#
 #######
