 #######
 ##  ###
 ##$.  #
 #     #
 # #** #
 #@  ###
 #######
