 ######
 #  .####
 # . $  #
 #  #$# #
 #   .$@#
 ########
