 #######
 # $.@##
 #  $  #
 #  $# #
 # .*. #
 #######
