 ######
 #... ###
 # @#$  #
 # $ $  #
 #   #  #
 ########
