 #######
 #   . ##
 # ##   ##
 #  $*#  #
 ##$     #
  # .#  @#
  ########
