 ########
 ###  ###
 ###   ##
 ###.$  #
 ###. # #
 #  $$  #
 #  +####
 ########
