 ######
 #   .#
 # ##$##
 # $   ###
 # #$  *.#
 #. @#   #
 #########
