 ######
 #.$..###
 # ## $ ##
 #   $ $.#
 #  #  $ #
 #   .# @#
 #########
