   ####
 ###  ###
 #  . . #
 # #.$# #
 #@$  $ #
 ###  ###
   ####
