   #####
   #@  #
 ### # ###
 #  .$*$ #
 # #   # #
 #  .#   #
 #########
