 #######
 ##  ###
 ##    #
 # $. .#
 # #$$ #
 #@ .###
 #######
