 ########
 ##@ .###
 # $$$  #
 # #.   #
 # .  ###
 ########
