 ########
 ###   ##
 ###   ##
 ### $  #
 ###$.# #
 #  $*  #
 #.. @###
 ########
