  #####
  #   ##
 ##. . ###
 #@$ * $ #
 # #  ## #
 #  *    #
 #########
