  #####
  #@  #
 ##$#$###
 # . .  #
 # #  $ #
 #  . ###
 ######
