 ########
 ###  +##
 ### $$##
 ###$   #
 ### .# #
 # . *  #
 #  $.###
 ########
