 #########
 ##   ####
 ## #. . #
 #.*$  #.#
 #.$  $  #
 #$$##   #
 #@ ######
 #########
