   ######
   #.   #
   #    #
 ###$ .##
 #   #.#
 # $$$.#
 #@ .$ #
 #######
