#          
#          
  ####  ###
  #  ####.#
  #.    # #
#####     #
#  #     @#
# $ $    .#
#   $    ##
####   ### 
   #####   
