#          
       ####
  #### #  #
  #  ###  #
  # .   # #
#####   . #
#  #      #
# $ $    .#
#   $   @##
####   ### 
   #####   
