#          
       ####
  #### #  #
  # @### .#
  #.$   # #
#####   $ #
#       * #
#       $ #
#        ##
##.#   ### 
 #######   
