#          
       ####
  #### # .#
  #  ###@*#
  #     # #
 ####     #
##    . . #
#     $   #
#     $$ ##
####   ### 
   #####   
