#          
       ####
  #### # .#
  #  ### .#
  #@$   $ #
#####    *#
#  #      #
#         #
##       ##
 ###   ### 
   #####   
