#          
       ####
  #### #  #
  #@ ### .#
  #.$   # #
 ####     #
 #       .#
 # #      #
 # $$    ##
 ###   ### 
   #####   
