#          
       ####
  #### #*@#
### *### *#
#.      # #
#####     #
####      #
#       $ #
#        ##
####   ### 
   #####   
