#          
       ####
  #### #*+#
  #  ### $#
  #.    # #
#####     #
#  #      #
#  #    $ #
#        ##
####   ### 
   #####   
