#          
       ####
  #### #*@#
  #  ### *#
  #     # #
  ###   $ #
 ###      #
 #      . #
 #       ##
 ###   ### 
   #####   
