#          
       ####
  #### #* #
 ##  ### .#
 #+ $   # #
#####   $ #
#        $#
#  #     .#
#        ##
####   ### 
   #####   
