#          
       ####
  #### #* #
 ##  ### .#
 #.     #@#
#####     #
#  #      #
# $ $   . #
#   $    ##
####   ### 
   #####   
