#          
       ####
  #### # @#
 ##  ### *#
 #.     # #
 ####     #
 #        #
 # #    $ #
 #       ##
 ###   ### 
   #####   
