#          
       ####
  #### # .#
  # @### .#
  #.$   # #
 ####     #
##       .#
# $$      #
#   $    ##
####   ### 
   #####   
