   ####
####  #
#  $  ##
# #$#  #
#  $   #
#.###  #
#.#### #
#. @   #
