 #####
 #   #
 #.#$##
 #    #
 #.#$ #
 #   ##
 #.#$#
##   #
# .#$#
# @  #
#  ###
