  ####
###  #
#    ##
#  #  ###
## . . .#
##$##.#$##
# $  @ $ #
#   ##   #
