 #######
 #  #  #
 #$ + $#
 # .#. #
##$.#.$##
# $ . $ #
#   #   #
