     #####
 #####   #
 # $ . # #
 # # $$  #
## ## # ##
#  $.$. #
# ##   ##
#  .@.##
