     ####
    ##  #
   ## . #
#### $  #
# $ $.@##
#  .  ##
