#   .#
# . @#
# # ###
# # $ ##
# *.   ##
#### $$ ##
   ##    #
    ##   #
     #####
