#          
       ####
  #### #@ #
 ##  ### *#
 #.     # #
 ####   $ #
####      #
#       * #
#        ##
####   ### 
   #####   
