#          
       ####
  #### #* #
 ##  ### .#
 #.     # #
#####     #
#  #    #@#
# $ $   . #
#   $    ##
####   ### 
   #####   
