#          
       ####
  #### #*@#
  #  ### *#
  #.  $ # #
 ####   $ #
##      . #
#         #
#        ##
####   ### 
   #####   
