#          
#          
  ####     
  #  ####  
  #@$   ###
  ###$ $  #
 ####    .#
 #      . #
 #       ##
 ###   ### 
   #####   
