#          
       ####
  #### # @#
  # *###**#
  #     # #
  ###     #
####      #
#       $ #
#        ##
##.#   ### 
 #######   
