#          
       ####
  #### #*+#
  #* ### $#
  #.    # #
#####     #
#  #      #
#       $ #
#        ##
####   ### 
   #####   
