#          
       ####
  #### #@ #
  #  ###**#
  #     # #
  ###   $ #
####      #
#       . #
#        ##
####   ### 
   #####   
