#          
       ####
  #### #*.#
 ##  ### .#
 #.     # #
#####     #
#  #      #
# $ $     #
#   $  @ ##
####   ### 
   #####   
