#          
       ####
  #### # .#
 ## @###. #
 #. $     #
#####     #
#  #    # #
# $ $   . #
#   $    ##
####   ### 
   #####   
